NW N N N N N N N N N N N N N N N N N N N N N N N N N N N N N N NE
W F F F F F F F F F F F F F F F F F F F F F F F F F F F F F F E
W F F F F F F F F M F F F F F F F F F F F F F M F F F F F F F E
MW F F F F F F F F F F F F F M F F F F F F F F F F F F F F F F E
W F F F F M F F F F F F F F F F F F F F F F F F F F F F F F F E
W F F F F F F F F F F F F F F F F F F F F F F F F M F F F F F E
W F F F F F F M F F M F F F F F F F F F F F F F F F F F F F F E
W F F M F F F F F F F F F F F F F F F M F F F F F F F F F F F E
W F F F F F F F F F F F F F P F F F F F F F F F F F F F M F F E
W F F F F F F F F F F F F F F F F F F F F F F F F F F F F F F E
W F F F M F F F F F F F F F F F F F F F F F F F M F F F F F F E
W F F F F F F F F F F F F F F F F F F F F F F F F F F F F F F E
W F F F F F F F F F F F F F F F F F M F F F F F F F F F F F F E
W F F F F M F F F M F F F F F F F F F F F F F F F F F F F F F E
W F F F F F F F F F F F F F F M F F F F F M F F F F F F F F F E
W F F F F F M F F F F F F F F F F F F F F F F F F F M F F F F E
W F F M F F F F F F F M F F F F F F M F F F F F F F F F F F F E
W F F F F F F F F F F F F F F F F F F F F F F F F F F F M F F E
W F F F F F F F F F F F F F F F F F F F F F F F F F F F F F F E
SW S S S S S S S S S S S S S S S S S S S S S S S S S S S S S S SE