NW N N N N N N N N N N N N N N N N N N N N N N N N N N N N N N NE
W F F F F F F F F F F F F F F F F F F F F F F F F F F F F F F E
W F F F F F F F F F F F F F F F F F F F F F F F F F F M F F F E
W F F F F F F F F F F F F F F F F F F F F F F F M F F F F F F E
W F F P F F F F F F F F F F F F F F F F F M F F F F F M F T F E
W F F F F F F F F F F F F F F F F F F F F F F F M F F F F F F E
W F F F F F F F F F F G F F F F F F F F F F F F F F F M F F F E
W F F F F F F F F F F F F F F F F F F F F F F F F F F F F F F E
W F F F F F F F F F F F F F F F F F F F F F F F M F F F F F F E
W F F F F F F F F F F F F F F F F F F F F F F F F F F M F F F E
W F F F F F F F F F F F F F F F F F F F F F F F F F F F F F F E
W F F F F F F F F F F F F F F F F F F F F F F F M F F F F F F E
W F F F F F F F F F F F F F F F F F F F F F F F F F F M F F F E
W F F F F F F F F F F F F F F F F F F F F F F F F F F F F F F E
W F F F F F F F F F F F F F F F F F F F F F F F M F F F F F F E
W F F F F F F F F F F F F F F F F F F F F F F F F F F M F F F E
W F F F F F F F F F F F F F F F F F F F F F F F F F F F F F F E
W F F F F F F F F F F F F F F F F F F F F F F F M F F F F F F E
W F F F F F F F F F F F F F F F F F F F F F F F F F F M F F F E
W F F F F F F F F F F F F F F F F F F F F F F F F F F F F F F E
SW S S S S S S S S S S S S S S S S S S S S S S S S S S S S S S SE