NW N N N N N N N N N N N N N N N N N N N N N N N N N N N N N N NE
W F F F F F F F F F F F F F F F F F F F F F F F F F F F F F F E
W F F F F F F F F F F F F F F F F F F F F F F F F F F F F F F E
W F F F F F F F F F F F F F F F F F F F F F F F F F F F F F F E
W F F F F F F F F F F F F F F F F F F F F F F F F F F F F F F E
W F F F F F F F F F F F F F F F F F F F F F F F F F F F F F F E
W F F F F F F F F F F F F F F F F F F F F F F F F F F F F F F E
W F F F F F F F F F F F F F F F F F F F F F F F F F F F F F F E
W F F F F F F F F F F F F F F F F F F F F F M M M F F F F F F E
W F F F F P F F F F F F F F F F F F F F F F M M M F F F F F F E
W F F F F F F F F F F F F F F F F F F F F F M M M F F F F F F E
W F F F F F F F F F F F F F F F F F F F F F F F F F F F F F F E
W F F F F F F F F F F F F F F F F F F F F F F F F F F F F F F E
W F F F F F F F F F F F F F F F F F F F F F F F F F F F F F F E
W F F F F F F F F F F F F F F F F F F F F F F F F F F F F F F E
W F F F F F F F F F F F F F F F F F F F F F F F F F F F F F F E
W F F F F F F F F F F F F F F F F F F F F F F F F F F F F F F E
W F F F F F F F F F F F F F F F F F F F F F F F F F F F F F F E
W F F F F F F F F F F F F F F F F F F F F F F F F F F F F F F E
W F F F F F F F F F F F F F F F F F F F F F F F F F F F F F F E
SW S S S S S S S S S S S S S S S S S S S S S S S S S S S S S S SE